--#####
###@--#
#-xb--#
#-xb-##
#--#-##
#-bb--#
#-----#
#######