--###---
--#x#---
###b####
#--b@bx#
###-####
--#b#---
--#x#---
--###---