--#######
###@---x#
#-xb----#
#-xb-#-##
#--#-#-##
#-bb---x#
#-------#
#########